111111111
10E0P0011
10010C011
111111111
